4 4
**********
*.....****
*.***...**
*.***.****
*.**....**
*.**.**.**
*....**...
***.******
*........*
**********